{
    "player": {
        "controllsConfig": {
            "GoLeft": 37,
            "GoRight": 39,
            "Jumb": 32
        },
        "name": "Alex",
        "ToDo": true,
        "Health": 10,
        "SpawnPoint": "0, 0",
        "Rectangle": {
            "X": 0,
            "Y": 0,
            "Width": 0,
            "Height": 0
        },
        "Position": "0, 0",
        "Velocity": "0, 0",
        "JumbCounter": 0,
        "texture": null,
        "contentName": "StickmanSingle",
        "SizeRelativeToWindowHeightInPerc": 17,
        "MinX": 0,
        "MinY": 0,
        "MaxX": 0,
        "CollisionResult": {
            "damage": 0,
            "velocity": "0, 0",
            "spawnPoint": "0, 0",
            "position": "0, 0",
            "jumbCounter": 0,
            "Collide": false
        }
    },
    "map": {
        "Width": 0,
        "Height": 0,
        "MapPlan": [
            [
                0,0,0,0,0,0,0,0,0,0,0,0,0,0,0,0,0,0,0,0,0,0,0,0,0,0,0,0,0,0,0,0,0,0,0,0,0,0,0,0,0,0,0,0,0,0,0,0,0,0,0,0,0,0,0,0,0,0,0,0
            ],
            [
                0,0,0,0,0,0,0,0,0,0,0,0,0,0,0,0,0,0,0,0,0,0,0,0,0,0,0,0,0,0,0,0,0,0,0,0,0,0,0,0,0,0,0,0,0,0,0,0,0,0,0,0,0,0,0,0,0,0,0,0
            ],
            [
                0,0,0,0,0,0,0,0,0,0,0,0,0,0,0,0,0,0,0,0,0,0,0,0,0,0,0,0,0,0,0,0,0,0,0,0,0,0,0,0,0,0,0,0,0,0,0,0,0,0,0,0,0,0,0,0,0,0,0,0
            ],
            [
                0,0,0,0,0,0,0,0,0,0,2,0,0,0,0,0,0,0,0,0,0,0,0,0,0,0,0,0,0,0,0,0,0,0,0,0,0,0,0,0,0,0,0,0,0,0,0,0,0,0,0,0,0,0,0,0,0,0,0,0
            ],
            [
                0,0,0,0,0,0,0,0,2,2,1,0,0,0,0,0,0,0,0,0,0,0,0,0,0,0,0,0,0,0,0,0,0,0,0,0,0,0,2,0,0,0,0,0,0,0,0,0,0,0,0,0,0,0,0,0,0,0,0,20
            ],
            [
                0,0,0,3,0,0,2,2,1,1,1,0,0,0,2,3,0,0,0,0,0,0,0,0,3,0,0,0,0,0,0,0,0,0,0,0,10,2,1,0,0,0,0,2,2,0,2,2,0,0,0,0,0,0,0,0,0,2,2,2
            ],
            [
                2,2,2,2,2,2,1,1,1,1,1,0,0,0,1,2,2,2,0,0,2,2,2,2,2,2,0,2,0,2,0,0,0,2,0,2,1,1,1,1,3,3,3,1,1,3,1,1,1,1,1,1,1,1,1,1,2,1,1,1
            ],
            [
                1,1,1,1,1,1,1,1,1,1,1,0,0,0,1,1,1,1,0,0,1,1,1,1,1,1,3,1,3,1,3,3,3,1,3,1,1,1,1,1,1,1,1,1,1,1,1,1,1,1,1,1,1,1,1,1,1,1,1,1
            ],
            [
                1,1,1,1,1,1,1,1,1,1,1,0,0,0,1,1,1,1,3,3,1,1,1,1,1,1,1,1,1,1,1,1,1,1,1,1,1,1,1,1,1,1,1,1,1,1,1,1,1,1,1,1,1,1,1,1,1,1,1,1
            ],
            [
                1,1,1,1,1,1,1,1,1,1,1,0,0,0,1,1,1,1,1,1,1,1,1,1,1,1,1,1,1,1,1,1,1,1,1,1,1,1,1,1,1,1,1,1,1,1,1,1,1,1,1,1,1,1,1,1,1,1,1,1
            ],
            [
                1,1,1,1,1,1,1,1,1,1,1,0,0,0,1,1,1,1,1,1,1,1,1,1,1,1,1,1,1,1,1,1,1,1,1,1,1,1,1,1,1,1,1,1,1,1,1,1,1,1,1,1,1,1,1,1,1,1,1,1
            ]
        ],
        "gameObjects": [],
        "ToDo": true
    }
}